+-+-+-+-+-+-+-+-+-+-+-+-+-+-+-+-+-+-+-+-+-+-+-+-+-+-+-+
############|   |       |#####|#######|       |   |   |
+-+-+-+-+-+#+-+ + +-+-+ +#+-+#+#+-+ +#+ +-+-+ + + +-+ +
|#####|    #|   | |     |#|###|#| | |#|   |     |     |
+#+ +#+-+-+#+ +-+ + +-+-+#+#+-+#+ + +#+-+-+ +-+-+ + +-+
|#| |#|#####|   | | |   |#|#|###|   |#####  |     |   |
+#+-+#+#+-+-+-+ + + +-+ +#+#+#+-+-+-+-+-+#+-+ +-+-+ +-+
|#|###|###|     | |   | |#|#|#|  #########|   |   |   |
+#+#+-+ +#+-+ + + +-+ + +#+#+#+ +#+-+-+-+-+ +-+-+ +-+-+
|#|###| |#|   | | |   | |#|###| |#|   |           |   |
+#+-+#+-+#+ +-+ +-+ +-+ +#+-+-+ +#+ +-+ +-+ +-+-+-+ +-+
|###|#####|   |    #####|#|     |#|     | | |   | |   |
+-+#+-+-+-+-+ +-+-+#+-+#+#+ +-+-+#+-+-+-+ + + + + + +-+
|  #########| |###|###|###|   |###|###|   |   | | |   |
+ +-+-+ +-+#+ +#+#+-+#+-+-+-+ +#+-+#+#+ +-+-+ + + +-+ +
| | |     |#|###|#|###|       |#|###|#|       |   |   |
+ + + +-+ +#+#+-+#+#+-+-+-+-+-+#+#+ +#+-+-+-+-+-+-+-+-+
| | | |   |#|#| |###    |     |#|#| |#######|     |   |
+ + + + +-+#+#+ +-+ +-+ + +-+ +#+#+-+-+-+-+#+ +-+ + +-+
|   | |   |###|   | |   |   | |###|     |  #####| |   |
+-+-+ +-+ +-+-+-+ +-+ +-+-+-+ +-+-+ +-+ + +-+ +#+-+-+ +
|   |   | |     |     |     | |   |   | |   | |###|   |
+ + +-+-+ + +-+ +-+ +-+-+-+ + +-+ +-+-+ +-+ + +-+#+-+-+
|         |   |     |   |     |     |   |     |  ##### 
+-+-+-+-+-+-+-+-+-+-+-+-+-+-+-+-+-+-+-+-+-+-+-+-+-+-+-+
